ALARM	AH L AA R M
CALENDAR	K AE L AH N D ER
CAMERA	K AE M ER AH
CAMERA(2)	K AE M R AH
COMPUTER	K AH M P Y UW T ER
DO	D UW
ENTRY	EH N T R IY
INTERNET	IH N T ER N EH T
MUSIC	M Y UW Z IH K
NEW	N UW
NEW(2)	N Y UW
NOTE	N OW T
PHONE	F OW N
RECORD	R AH K AO R D
RECORD(2)	R EH K ER D
RECORD(3)	R IH K AO R D
TO	T UW
TO(2)	T IH
TO(3)	T AH
TWEET	T W IY T
